%%%%%%%%%%%%%%%%%%%%%%%
%      P      .%    . %
% %%%%%%% %%%%%% %  % %
%    %           %  % %
%        .      %     %
%%%%%%%%%%%%%%  %%%%%%%
% .                   %
%%%%%%%%%%%%%%%%%%%%%%%
